1111111111111111111111111
1P0000001C0000000000000E1
1011101110111110111111101
1B0000C000B0000C0000B0001
1011111011101110111011101
1C0000B0000000B0000C00001
1110111011110111110111111
1B000C0000B000C0000B00001
1011101110111011101110111
1C0000B000C0000B0000C0B01
1111111111111111111111111