1111111111
1P000000E1
1010111011
100B000000
1011101011
1B00000001
1111111111