1111111111
1P00000001
1010111011
1C0B0C0001
1011101011
1B000000C1
1111111111