1111111111
1P000000E1
1010111011
1C0B0C0001
10111010111
1B000000C1
1111111111