111111111111111
10C0B11B001C001
100000100C11101
100P001100E0001
110000110000C01
1110C00001100B1
111111111111111