1111111111111
1P0001C0000E1
1011101011101
1C0B000B00C01
1010111010101
1C0000B0000C1
1111111111111