11111111111111111111111111111
1EBB00000B00000C00000C000B001
1B100101001000001010010010101
10100100101010100010010010101
1P0000000C00C0000B000000000C1
11111111111111111111111111111