111111111111111
1P0000001C000E1
111011101110111
1B00C0010000B01
101110111011101
1C000B000C000C1
111111111111111