11111111111111111111
1C0000B11111000E1111
100000000B00000C0001
100B111111100B001111
1P110000B00000000111
101111111111111C0001
1000000C111111100111
111111100000B0001111
11111111111111111111