111111111111111111111
1P0000C000001000000E1
111011101110111011101
1B000B000C0000B000001
101111101011101111001
1C0000B0000C0000C0001
111011111111111011111
1B0000010000001B00001
101111101011101111001
1C0000B0000C0000C0B01
111111111111111111111